


###########
#.....
#.####
#*#  #
#.####
#.....
#.####
#.####
#.....
######